pppppppppppppppp
p--w--P--w-WWC-p
pW---w-WCwWC--Wp
p--wC-CwW---W-Wp
p-W-W-WW--W-W--p
pMww---wCwWwwW-p
pCW--W-w-W--wW-p
pWCw-ww-CW-WW--p
p--W-Wwww-WW-WWp
pWwwW----W-wW--p
pM-------Ww-MW-p
pww-www-w--w-wWp
p---W--W-W--w--p
pW--ww-www-www-p
p--W-w-ww--w--Wp
pppppppppppppppp