WWWWWWWW
W--W--PW
WW---W-W
W--W---W
W-W-W-WW
WMWW---W
W-W--W-W
WWWWWWWW