WWWWWWWWWWWWWWWW
W--W--P--W-WW--W
WW---W-W-WW---WW
W--W---WW---W-WW
W-W-W-WW--W-W--W
WMWW---WWWWWWW-W
W-W--W-W-W--WW-W
WWWW-WW--W-WW--W
W--W-WWWW-WW-WWW
WWWWW----W-WW--W
WM-------WW-MW-W
WWW-WWW-W--W-WWW
W---W--W-W--W--W
WW--WW-WWW-WWW-W
W--W-W-WW--W--WW
WWWWWWWWWWWWWWWW