pppppppppppppppp
p--w--P--w-WWC-p
pW---w-WCwWC--Wp
p--wC-CwW---W-Wp
p-W-W-WW-MW-W--p
pMww-M-wCwWwwW-p
pCW--W-w-W--wW-p
pWCw-ww-CW-WW--p
pMMW-Wwww-WW-WWp
pWwwW----W-wW--p
pM------MWw-MW-p
pww-www-w--w-wWp
p---W--W-W--w--p
pW-Mww-www-www-p
p--W-w-ww--w--Wp
pppppppppppppppp