pppppppppppppppp
p--w--P--w-WW--p
pW---w-W-wW---Wp
p--w---wW---W-Wp
p-W-W-WW--W-W--p
pMww---wwwWwwW-p
p-W--W-w-W--wW-p
pWww-ww--W-WW--p
p--W-Wwww-WW-WWp
pWwwW----W-wW--p
pM-------Ww-MW-p
pww-www-w--w-wWp
p---W--W-W--w--p
pW--ww-www-www-p
p--W-w-ww--w--Wp
pppppppppppppppp