pppppppppppppppp
p--w--P--w-WWC-p
pW---w-WCwWC--Wp
p--w--wwW---W-Wp
p-W-W-WW-M--WM-p
pMww---wCwWwwW-p
pCW--W-w-W--wW-p
pWCw-ww-CW-WWC-p
p--W-Wwww-WW-WWp
pWwwWC---W-wW--p
p----M---Ww--W-p
pww-www-w--wMwWp
p---W--W-W-Cw--p
pW-Mww-www-www-p
pC-W-w-ww--w--Wp
pppppppppppppppp