WWWWWWWWWWWWWWWW
W--w--P--w-WW--W
WW---w-W-wW---WW
W--w---wW---W-WW
W-W-W-WW--W-W--W
WMww---wwwWwwW-W
W-W--W-w-W--wW-W
WWww-ww--W-WW--W
W--W-Wwww-WW-WWW
WWwwW----W-WW--W
WM-------WW-MW-W
Www-www-w--W-WWW
W---W--W-W--W--W
WW--ww-www-WWW-W
W--W-w-ww--W--WW
WWWWWWWWWWWWWWWW